###################
#........#........#
#O##.###.#.###.##O#
#.................#
#.##.#.#####.#.##.#
#O...#...#...#...O#
####.###O#.###O####
#.....#..#...#....#
#.#..O..........#.#  
#.#.#.###_##.#..#.#
#...#.#FFFF#.#.O..#
#.#.#.######.#..#.#
#.O..........#..O.#
####.#.#####.#.####
#O.......#.......O#
#.##.###.#.###.##.#
#..#...........#..#
##.#.#.#####.#.#.##
#....#...#...#....#
#.######.#.######.#
#O..P............O#
###################